NO ./path_to_the_north_texture
SO ./path_to_the_south_texture
                        WE                                      ./path_to_the_west_texture
EA ./path_to_the_east_texture

F 220,                                                         100,0
C 225,30                                                                                                         ,0

        11111111111  11111111111111
        10000011111 10000000000001
        10110000001110000000000001
        100100000000 0  000000000011
1111111110110000011111111000000000001
100000011000001110111111111111111111
1111011111111101110000001000111111              1111
1          111111111011101010010001             1001                  
1111    11010101110000001000111111              1111
1000    000000001100000010001
1000    0000000011010100100011                    
1100    1110101011111011110N01111111111111111111111111111111111111111111111111111111
11110111 1110111 101111010001
11111111 11111   1111111111111
11
1
111111111111111111