NO ./path_to_the_north_texture
SO ./path_to_the_south_texture
WE ./path_to_the_west_texture
EA ./path_to_the_east_texture

F 220,100,0
C 225,30,200

111111111111
1         11
1       0001
1000000 0011
1000S000001
111111111111
   11
111111111111